AccessID	Sequence	Line
LC1_sorted	TAAGGCGA-GCGATCTA	LC
LC9_sorted	CGTACTAG-GCGATCTA	LC
LC17_sorted	AGGCAGAA-GCGATCTA	LC
LD5_sorted	TCCTGAGC-GCGATCTA	LD
LD13_sorted	GGACTCCT-GCGATCTA	LD
LB1_sorted	TAGGCATG-GCGATCTA	LB
LB9_sorted	CTCTCTAC-GCGATCTA	LB
LB17_sorted	CAGAGAGG-GCGATCTA	LB
SWS5_sorted	GCTACGCT-GCGATCTA	SWS
SWS13_sorted	CGAGGCTG-GCGATCTA	SWS
IFT1_sorted	AAGAGGCA-GCGATCTA	IFT
IFT12_sorted	GTAGAGGA-GCGATCTA	IFT
LC2_sorted	TAAGGCGA-ATAGAGAG	LC
LC10_sorted	CGTACTAG-ATAGAGAG	LC
LC18_sorted	AGGCAGAA-ATAGAGAG	LC
LD6_sorted	TCCTGAGC-ATAGAGAG	LD
LD14_sorted	GGACTCCT-ATAGAGAG	LD
LB2_sorted	TAGGCATG-ATAGAGAG	LB
LB10_sorted	CTCTCTAC-ATAGAGAG	LB
LB18_sorted	CAGAGAGG-ATAGAGAG	LB
SWS6_sorted	GCTACGCT-ATAGAGAG	SWS
SWS14_sorted	CGAGGCTG-ATAGAGAG	SWS
IFT2_sorted	AAGAGGCA-ATAGAGAG	IFT
IFT13_sorted	GTAGAGGA-ATAGAGAG	IFT
LC3_sorted	TAAGGCGA-AGAGGATA	LC
LC11_sorted	CGTACTAG-AGAGGATA	LC
LC19_sorted	AGGCAGAA-AGAGGATA	LC
LD7_sorted	TCCTGAGC-AGAGGATA	LD
LD15_sorted	GGACTCCT-AGAGGATA	LD
LB3_sorted	TAGGCATG-AGAGGATA	LB
LB11_sorted	CTCTCTAC-AGAGGATA	LB
LB19_sorted	CAGAGAGG-AGAGGATA	LB
SWS7_sorted	GCTACGCT-AGAGGATA	SWS
SWS15_sorted	CGAGGCTG-AGAGGATA	SWS
IFT3_sorted	AAGAGGCA-AGAGGATA	IFT
IFT15_sorted	GTAGAGGA-AGAGGATA	IFT
LC4_sorted	TAAGGCGA-TCTACTCT	LC
LC12_sorted	CGTACTAG-TCTACTCT	LC
LC20_sorted	AGGCAGAA-TCTACTCT	LC
LD8_sorted	TCCTGAGC-TCTACTCT	LD
LD16_sorted	GGACTCCT-TCTACTCT	LD
LB4_sorted	TAGGCATG-TCTACTCT	LB
LB12_sorted	CTCTCTAC-TCTACTCT	LB
LB20_sorted	CAGAGAGG-TCTACTCT	LB
SWS8_sorted	GCTACGCT-TCTACTCT	SWS
SWS16_sorted	CGAGGCTG-TCTACTCT	SWS
IFT5_sorted	AAGAGGCA-TCTACTCT	IFT
IFT16_sorted	GTAGAGGA-TCTACTCT	IFT
LC5_sorted	TAAGGCGA-CTCCTTAC	LC
LC13_sorted	CGTACTAG-CTCCTTAC	LC
LD1_sorted	AGGCAGAA-CTCCTTAC	LD
LD9_sorted	TCCTGAGC-CTCCTTAC	LD
LD17_sorted	GGACTCCT-CTCCTTAC	LD
LB5_sorted	TAGGCATG-CTCCTTAC	LB
LB13_sorted	CTCTCTAC-CTCCTTAC	LB
SWS1_sorted	CAGAGAGG-CTCCTTAC	SWS
SWS9_sorted	GCTACGCT-CTCCTTAC	SWS
SWS17_sorted	CGAGGCTG-CTCCTTAC	SWS
IFT8_sorted	AAGAGGCA-CTCCTTAC	IFT
IFT17_sorted	GTAGAGGA-CTCCTTAC	IFT
LC6_sorted	TAAGGCGA-TATGCAGT	LC
LC14_sorted	CGTACTAG-TATGCAGT	LC
LD2_sorted	AGGCAGAA-TATGCAGT	LD
LD10_sorted	TCCTGAGC-TATGCAGT	LD
LD18_sorted	GGACTCCT-TATGCAGT	LD
LB6_sorted	TAGGCATG-TATGCAGT	LB
LB14_sorted	CTCTCTAC-TATGCAGT	LB
SWS2_sorted	CAGAGAGG-TATGCAGT	SWS
SWS10_sorted	GCTACGCT-TATGCAGT	SWS
SWS18_sorted	CGAGGCTG-TATGCAGT	SWS
IFT9_sorted	AAGAGGCA-TATGCAGT	IFT
IFT19_sorted	GTAGAGGA-TATGCAGT	IFT
LC7_sorted	TAAGGCGA-TACTCCTT	LC
LC15_sorted	CGTACTAG-TACTCCTT	LC
LD3_sorted	AGGCAGAA-TACTCCTT	LD
LD11_sorted	TCCTGAGC-TACTCCTT	LD
LD19_sorted	GGACTCCT-TACTCCTT	LD
LB7_sorted	TAGGCATG-TACTCCTT	LB
LB15_sorted	CTCTCTAC-TACTCCTT	LB
SWS3_sorted	CAGAGAGG-TACTCCTT	SWS
SWS11_sorted	GCTACGCT-TACTCCTT	SWS
SWS19_sorted	CGAGGCTG-TACTCCTT	SWS
IFT10_sorted	AAGAGGCA-TACTCCTT	IFT
IFT20_sorted	GTAGAGGA-TACTCCTT	IFT
LC8_sorted	TAAGGCGA-AGGCTTAG	LC
LC16_sorted	CGTACTAG-AGGCTTAG	LC
LD4_sorted	AGGCAGAA-AGGCTTAG	LD
LD12_sorted	TCCTGAGC-AGGCTTAG	LD
LD20_sorted	GGACTCCT-AGGCTTAG	LD
LB8_sorted	TAGGCATG-AGGCTTAG	LB
LB16_sorted	CTCTCTAC-AGGCTTAG	LB
SWS4_sorted	CAGAGAGG-AGGCTTAG	SWS
SWS12_sorted	GCTACGCT-AGGCTTAG	SWS
SWS20_sorted	CGAGGCTG-AGGCTTAG	SWS
IFT11_sorted	AAGAGGCA-AGGCTTAG	IFT
LC1_rep_sorted	GTAGAGGA-AGGCTTAG	LC
LA1_sorted	TAAGGCGA-GCATGAGG	LA
LA9_sorted	CGTACTAG-GCATGAGG	LA
LA17_sorted	AGGCAGAA-GCATGAGG	LA
LE5_sorted	TCCTGAGC-GCATGAGG	LE
LE13_sorted	GGACTCCT-GCATGAGG	LE
NT1_sorted	TAGGCATG-GCATGAGG	NT
NT9_sorted	CTCTCTAC-GCATGAGG	NT
WT2_sorted	CAGAGAGG-GCATGAGG	WT
WT10_sorted	GCTACGCT-GCATGAGG	WT
WT18_sorted	CGAGGCTG-GCATGAGG	WT
SWT6_sorted	AAGAGGCA-GCATGAGG	SWT
SWT14_sorted	GTAGAGGA-GCATGAGG	SWT
LA2_sorted	TAAGGCGA-TTATCGAG	LA
LA10_sorted	CGTACTAG-TTATCGAG	LA
LA18_sorted	AGGCAGAA-TTATCGAG	LA
LE6_sorted	TCCTGAGC-TTATCGAG	LE
LE14_sorted	GGACTCCT-TTATCGAG	LE
NT2_sorted	TAGGCATG-TTATCGAG	NT
NT10_sorted	CTCTCTAC-TTATCGAG	NT
WT3_sorted	CAGAGAGG-TTATCGAG	WT
WT11_sorted	GCTACGCT-TTATCGAG	WT
WT19_sorted	CGAGGCTG-TTATCGAG	WT
SWT7_sorted	AAGAGGCA-TTATCGAG	SWT
SWT15_sorted	GTAGAGGA-TTATCGAG	SWT
LA3_sorted	TAAGGCGA-GATATTAA	LA
LA11_sorted	CGTACTAG-GATATTAA	LA
LA19_sorted	AGGCAGAA-GATATTAA	LA
LE7_sorted	TCCTGAGC-GATATTAA	LE
LE15_sorted	GGACTCCT-GATATTAA	LE
NT3_sorted	TAGGCATG-GATATTAA	NT
NT11_sorted	CTCTCTAC-GATATTAA	NT
WT4_sorted	CAGAGAGG-GATATTAA	WT
WT12_sorted	GCTACGCT-GATATTAA	WT
WT20_sorted	CGAGGCTG-GATATTAA	WT
SWT8_sorted	AAGAGGCA-GATATTAA	SWT
SWT16_sorted	GTAGAGGA-GATATTAA	SWT
LA4_sorted	TAAGGCGA-CCGATAGA	LA
LA12_sorted	CGTACTAG-CCGATAGA	LA
LA20_sorted	AGGCAGAA-CCGATAGA	LA
LE8_sorted	TCCTGAGC-CCGATAGA	LE
LE16_sorted	GGACTCCT-CCGATAGA	LE
NT4_sorted	TAGGCATG-CCGATAGA	NT
NT12_sorted	CTCTCTAC-CCGATAGA	NT
WT5_sorted	CAGAGAGG-CCGATAGA	WT
WT13_sorted	GCTACGCT-CCGATAGA	WT
SWT1_sorted	CGAGGCTG-CCGATAGA	SWT
SWT9_sorted	AAGAGGCA-CCGATAGA	SWT
SWT17_sorted	GTAGAGGA-CCGATAGA	SWT
LA5_sorted	TAAGGCGA-AAGAACTC	LA
LA13_sorted	CGTACTAG-AAGAACTC	LA
LE1_sorted	AGGCAGAA-AAGAACTC	LE
LE9_sorted	TCCTGAGC-AAGAACTC	LE
LE17_sorted	GGACTCCT-AAGAACTC	LE
NT5_sorted	TAGGCATG-AAGAACTC	NT
NT13_sorted	CTCTCTAC-AAGAACTC	NT
WT6_sorted	CAGAGAGG-AAGAACTC	WT
WT14_sorted	GCTACGCT-AAGAACTC	WT
SWT2_sorted	CGAGGCTG-AAGAACTC	SWT
SWT10_sorted	AAGAGGCA-AAGAACTC	SWT
SWT18_sorted	GTAGAGGA-AAGAACTC	SWT
LA6_sorted	TAAGGCGA-ATCTTAAC	LA
LA14_sorted	CGTACTAG-ATCTTAAC	LA
LE2_sorted	AGGCAGAA-ATCTTAAC	LE
LE10_sorted	TCCTGAGC-ATCTTAAC	LE
LE18_sorted	GGACTCCT-ATCTTAAC	LE
NT6_sorted	TAGGCATG-ATCTTAAC	NT
NT14_sorted	CTCTCTAC-ATCTTAAC	NT
WT7_sorted	CAGAGAGG-ATCTTAAC	WT
WT15_sorted	GCTACGCT-ATCTTAAC	WT
SWT3_sorted	CGAGGCTG-ATCTTAAC	SWT
SWT11_sorted	AAGAGGCA-ATCTTAAC	SWT
SWT19_sorted	GTAGAGGA-ATCTTAAC	SWT
LA7_sorted	TAAGGCGA-CAGAATAT	LA
LA15_sorted	CGTACTAG-CAGAATAT	LA
LE3_sorted	AGGCAGAA-CAGAATAT	LE
LE11_sorted	TCCTGAGC-CAGAATAT	LE
LE19_sorted	GGACTCCT-CAGAATAT	LE
NT7_sorted	TAGGCATG-CAGAATAT	NT
NT15_sorted	CTCTCTAC-CAGAATAT	NT
WT8_sorted	CAGAGAGG-CAGAATAT	WT
WT16_sorted	GCTACGCT-CAGAATAT	WT
SWT4_sorted	CGAGGCTG-CAGAATAT	SWT
SWT12_sorted	AAGAGGCA-CAGAATAT	SWT
SWT20_sorted	GTAGAGGA-CAGAATAT	SWT
LA8_sorted	TAAGGCGA-CGCGTAGT	LA
LA16_sorted	CGTACTAG-CGCGTAGT	LA
LE4_sorted	AGGCAGAA-CGCGTAGT	LE
LE12_sorted	TCCTGAGC-CGCGTAGT	LE
LE20_sorted	GGACTCCT-CGCGTAGT	LE
NT8_sorted	TAGGCATG-CGCGTAGT	NT
WT1_sorted	CTCTCTAC-CGCGTAGT	WT
WT9_sorted	CAGAGAGG-CGCGTAGT	WT
WT17_sorted	GCTACGCT-CGCGTAGT	WT
SWT5_sorted	CGAGGCTG-CGCGTAGT	SWT
SWT13_sorted	AAGAGGCA-CGCGTAGT	SWT
S3_5_sorted	GTAGAGGA-CGCGTAGT	S3
KR1_sorted	CATACGTA-GCGATCTA	KR
KR2_sorted	CATACGTA-ATAGAGAG	KR
KR3_sorted	CATACGTA-AGAGGATA	KR
KR4_sorted	CATACGTA-TCTACTCT	KR
KR5_sorted	CATACGTA-CTCCTTAC	KR
S3_1_sorted	CATACGTA-TATGCAGT	S3
S3_2_sorted	CATACGTA-TACTCCTT	S3
s3_3_sorted	CATACGTA-AGGCTTAG	S3
S3_4_sorted	GAACACTG-ATAGAGAG	S3